2022-02-22-00:00 18
2022-02-23-00:00 28
2022-02-24-00:00 42
2022-02-25-00:00 47
2022-02-26-00:00 73
2022-02-27-00:00 82
2022-02-28-00:00 87
2022-03-01-00:00 91
2022-03-02-00:00 92
2022-03-03-00:00 96
2022-03-04-00:00 96
2022-03-05-00:00 96
2022-03-06-00:00 100
2022-03-07-00:00 101
2022-03-08-00:00 103
2022-03-09-00:00 105
2022-03-10-00:00 107
2022-03-11-00:00 112
2022-03-11-12:14 114
2022-03-12-00:00 114
2022-03-13-00:00 115
2022-03-14-00:00 116
2022-03-15-00:00 116
2022-03-16-00:00 118
2022-03-17-00:00 123
2022-03-18-00:00 126
2022-03-19-00:00 127
2022-03-20-00:00 127
2022-03-21-00:00 127
2022-03-22-00:00 131
2022-03-23-00:00 133
2022-03-24-00:00 136
2022-03-25-00:00 138
2022-03-26-00:00 138
2022-03-27-00:00 138
2022-03-28-00:00 139
2022-03-29-00:00 139
2022-03-30-00:00 140
2022-03-31-00:00 144
2022-04-01-00:00 145
2022-04-02-00:00 146
2022-04-03-00:00 146
2022-04-04-00:00 148
2022-04-05-00:00 151
2022-04-06-00:00 153
2022-04-07-00:00 155
2022-04-08-00:00 157
2022-04-09-00:00 159
2022-04-10-00:00 159
2022-04-11-00:00 159
2022-04-12-00:00
2022-04-13-00:00
2022-04-14-00:00
2022-04-15-00:00
2022-04-16-00:00
2022-04-17-00:00
2022-04-18-00:00
2022-04-19-00:00
2022-04-20-00:00
2022-04-21-00:00
2022-04-22-00:00
2022-04-23-00:00
2022-04-24-00:00
2022-04-25-00:00
2022-04-26-00:00
2022-04-27-00:00
2022-04-28-00:00
2022-04-29-00:00
2022-04-30-00:00
2022-05-01-00:00
2022-05-02-00:00
2022-05-03-00:00
2022-05-04-00:00
2022-05-05-00:00
2022-05-12-00:00
2022-05-13-00:00
2022-05-14-00:00
2022-05-15-00:00
2022-05-16-00:00
2022-05-17-00:00
2022-05-18-00:00
2022-05-19-00:00
2022-05-20-00:00
2022-05-21-00:00
2022-05-22-00:00
2022-05-23-00:00
2022-05-24-00:00
2022-05-25-00:00
2022-05-26-00:00
2022-05-27-00:00
2022-05-28-00:00
2022-05-29-00:00
2022-05-30-00:00
2022-05-31-00:00
2022-06-01-00:00
2022-06-02-00:00
2022-06-03-00:00
2022-06-04-00:00
2022-06-05-00:00
2022-06-06-00:00
2022-06-07-00:00
2022-06-08-00:00
2022-06-09-00:00
2022-06-10-00:00
2022-06-11-00:00
2022-06-17-00:00
2022-06-18-00:00
2022-06-19-00:00
2022-06-20-00:00
2022-06-21-00:00
2022-06-22-00:00
2022-06-23-00:00
2022-06-24-00:00
2022-06-25-00:00
2022-06-26-00:00
2022-06-27-00:00
2022-06-28-00:00
2022-06-29-00:00
2022-06-30-00:00
2022-07-01-00:00
2022-07-02-00:00
2022-07-03-00:00
2022-07-04-00:00
2022-07-05-00:00
2022-07-06-00:00
2022-07-07-00:00
2022-07-08-00:00
2022-07-09-00:00
2022-07-10-00:00
2022-07-11-00:00
2022-07-12-00:00
2022-07-13-00:00
2022-07-14-00:00
2022-07-15-00:00
2022-07-16-00:00
2022-07-17-00:00
2022-07-18-00:00
2022-07-19-00:00
2022-07-20-00:00
2022-07-21-00:00
2022-07-22-00:00
2022-07-23-00:00
2022-07-24-00:00
2022-07-25-00:00
2022-07-26-00:00
2022-07-27-00:00
2022-07-28-00:00
2022-07-29-00:00
2022-08-01-00:00
2022-08-03-00:00
2022-08-04-00:00
2022-08-05-00:00
2022-08-06-00:00
2022-08-07-00:00
2022-08-08-00:00
2022-08-09-00:00
2022-08-10-00:00
2022-08-11-00:00
2022-08-12-00:00
2022-08-13-00:00
2022-08-14-00:00
2022-08-15-00:00
2022-08-16-00:00
2022-08-17-00:00
2022-08-18-00:00
2022-08-19-00:00
2022-08-20-00:00
2022-08-21-00:00
2022-08-22-00:00
2022-08-23-00:00
2022-08-24-00:00
2022-08-25-00:00
2022-08-26-00:00
2022-08-27-00:00
2022-08-28-00:00
2022-08-29-00:00
2022-08-30-00:00
